11111111111111
10000000000111
1000P000CC0111
10000000CC0001
10000100000001
10000000000001
11111111111111
