11111111111111
1C001101000111
11010100000111
10P100000C0001
10100000000011
10000X000000E1
11111111111111
