111111111111111111111111111
100000010000000000000X00001
100000010111000000000000001
100000010101000000000000001
100000010101000000000000001
100000010100000000000000001
100000010100000000000000001
100000010100000C00000000001
100000010100000C0P000000001
1000000101000000C0000000001
100000010100000000000000001
100000011111111111111111101
100000000000000000000000001
111111111111111111111111111
